moose: a large animal with antlers
homework: assignment done at home
break: shatter
council: a group of people making plans
sub: something that travels under water
purchase: buy
eyelid: protects your eye
bike: something you pedal to make its wheels move
yearn: to really long for something
ill: sick
principal: the head of a school
geese: large birds that make honking sound
feet: at  he end of our legs 
vacant: empty
banner: flag
sloppy: messy
chipmunk: a small animal resembling a squirrel
crosswalk: where you should cross street
rainbow: a band of colors
mammoth: large
paws: feet
gracious: polite
sheep: animals whose fur is used for wool
sandbox: where kids play with sand
boss: the person in charge of a job    
drum: something you hit to make sounds
garage: a place to park cars
frayed: worn
task: job
applesauce: made when cooking apples
exam: a kind of test
mitt: what baseball players catch with
rude: not polite
zoo: a place where animals are kept
foe: enemy 
fern: a kind of plant
limb: a branch of a tree
host: one who gives the party
hairbrush: what you use to brush hair
peak: top of a mountain
auto: a form of transportation
fawn: a baby deer
fur: covering of most animals
aunt: female relative
keyboard: part of a piano that you play
waterfall: when water drops over a cliff
fir: a kind of evergreen tree
creek: a smaller, moving body of water
dinghy: a small boat
piglet: a baby pig
joey: a baby kangaroo
scorekeeper: someone who keeps score
gosling: a baby goose
rowboat: small boat  moved by rowing
calf: a baby cow, elephant, or whale
drowsy: sleepy
bright: light
dim: not much light
lunchtime: middle meal of the day
shiver: shudder
pleasure: a happy feeling
voyage: trip
lurk: wait
annual: yearly
bothersome: annoying
kid: a young goat
lead: to be at the beginning/a type of metal
record: to write down/something important  
infant: baby
counsel: to give advice
slumber: sleep
bungalow: a small, one story house
bus: what some kids ride to school 
beehive: where bees make honey
stake: a stick that you hammer into ground
kit: a baby fox 
math: the study of numbers, shapes, and measurements 
freighter: a ship that carries cargo 
railroad: what trains travel on
assist: help
echoes: repeated sounds
lab: where scientists do their research
threw: past tense of throw
cellar: at the bottom of the house
reply: answer
springboard: flexible board to jump from
vast: huge
wail: cry
wild: untamed
slosh: splash
spaceship: what an astronaut rides in
lend: to give something
halves: two equal parts
helm: h
hikikik: fsdgdfg
bury: to cover up
absent: missing
mysteries: things that are secret or hard to explain
steak: meat you eat
plaza: an open space in a city or town
oxen: large farm animals in the cattle family
flexible: bends easily
grandchildren: children of your children
deep: many feet of water
stalk: stem
rigid: stiff
live: living/to dwell
catfish: a fish with whiskers
repair: fix
bravo: what an audience yells when they like the performance
attic: at the top of the house
shriek: a loud sound
pizza: a kind of pie with cheese and tomatoes on a crust
through: from here to there
borrow: you get something
berry: a fruit
kindergarten: before 1st grade
pain: what you feel when something bad happens
adult: grownup
coast: land along the sea 
cygnet: a young swan
glee: joy
loft: a room just under the roof of a building
birdbath: bath for birds
turtleneck: a long neck
cub: a young bear, lion, or tiger
foal: a young horse or donkey
prank: trick
patio: a paved area near a house
principle: a rule
ballet: a form of dance
whale: a large animal living in the sea
ant: an insect
peek: to look
pause: take a break
dove: bird/past tense of dive  
orbit: circle
loyal: faithful
neat: tidy
wind: air that moves/to turn 
hillside: steep, sloping land
shallow: not much water
feeble: weak
sturdy: strong
meadow: field
furious: angry
overcast: cloudy
sketches: quick drawings
plea: to beg for something
noodle: made of flour, water, and eggs
